Manas,91,69,96,256,85.33333333333333,A
SM,92,96,90,278,92.66666666666667,A+
SJ,58,48,36,142,47.333333333333336,E
Vishal,11,14,8,33,11.0,FAIL
Narendra,33,44,66,143,47.666666666666664,E
Vansh,87,56,89,232,77.33333333333333,B
pankaj,89,90,78,257,85.66666666666667,A
ABC,100,89,98,287,95.66666666666667,A+
BHARGAV SAHU,85,90,98,273,91.0,A+
Amit,89,86,57,232,77.33333333333333,B
James ,65,81,94,240,80.0,A
